1111111111111111111111111111111111111111111111111111111111111
1000000000000000000000000000000000000000000000000000000000001
1000000000000000000000000000000000000000000000000000000000001
1000000000000000000000000000000000000000000000000000000000001
1000000000000000000000000000000000000000000000000000000000001
1000000000000000000000000000000000000000000000000000000000001
1000000000000000000000000000000000000000000000000000000000001
1000000000000000000000000000000000000000000000000000000000001
1000000000000000000000000000000000000000000000000000000000001
1000000000000000000000000000000000000000000000000000000000001
1000000000000000000000000000111100001111101100000000000000001
1000000000000000000000000001110000001110001100000000000000001
1000000000000000000000000111000000001100001100000000000000001
1000000000000000000000001110000000000000001100000000000000001
1000000000000000000000111000000000000000001100000000000000001
1000000000000000000001110000000000000000001100000000000000001
1000000000000000000111000000000000000000001100000000000000001
1000000000000000011110000000000000000000011100000000000000001
1000000000000000111000000000000000000000111100000000000000001
1000000000000011100000000000000000000011110000000000000000001
1000000000000111000000000000000000001111000000000000000000001
1000000000000111111111111111110000111000000000000000000000001
1000000000000111111111111111110000111000000000000000000000001
1000000000000000000000000000110000111000001100000000000000001
1000000000000000000000000000110000111000011100000000000000001
1000000000000000000000000000110000111001111100000000000000001
10000000000000000000000000C0110000000000000000000000000000001
10000000000000000000000000P0110000000000000000000000000000001
1000000000000000000000000000000000000000000000000000000000001
1000000000000000000000000000000000000000000000000000000000001
1000000000000000000000000000000000000000000000000000000000001
1000000000000000000000000000000000000000000000000000000000001
1111111111111111111111111111111111111111111111111111111111111