1111111111111111111111111111111111111111111111111111111111111111111111111111111111111111111111111111111
1111111111111111111110000000000000000000000000000000000000000000000000000000000011111111111111111111111
1111111111111111111110000000000000000000000000000000000000000000000000000000000011111111111111111111111
1111111111111111111110000000000000000000000000000000000000000000000000000000000011111111111111111111111
1111111111111111111110000000000000000000000000000000000000000000000000000000000011111111111111111111111
1111111111111111111110000000000000000000000000000000000000000000000000000000000011111111111111111111111
1111111111111111111110000000000000000000000000000000000000000000000000000000000011111111111111111111111
1111111111111111111110000000000000000000000000000000000000000000000000000000000011111111111111111111111
1111111111111111111110000000000000000000000000000000000000000000000000000000000011111111111111111111111
1111111111111111111110000000000000000000000000000000000000000000000000000000000011111111111111111111111
1111111111111111111110000000000000000000000000000000000000000000000000000000000011111111111111111111111
1111111111111111111110000000000000000000000000000000000000000000000000000000000011111111111111111111111
1111111111111111111110000000000000000000000000000000000000000000000000000000000011111111111111111111111
1111111111111111111110000000000000000000000000001111000011111011000000000000000011111111111111111111111
1111111111111111111110000000000000000000000000011100000011100011000000000000000011111111111111111111111
1111111111111111111110000000000000000000000001110000000011000011000000000000000011111111111111111111111
1111111111111111111110000000000000000000011100000000000000000011000000000000000011111111111111111111111
1111111111111111111110000000000000000001110000000000000000000011000000000000000011111111111111111111111
1111111111111111111110000000000000000111100000000000000000000111000000000000000011111111111111111111111
1111111111111111111110000000000000001110000000000000000000001111000000000000000011111111111111111111111
1111111111111111111110000000000000111000000000000000000000111100000000000000000011111111111111111111111
1111111111111111111110000000000001110000000000000000000011110000000000000000000011111111111111111111111
1111111111111111111110000000000001111111111111111100001110000000000000000000000011111111111111111111111
1111111111111111111110000000000001111111111111111100001110000000000000000000000011111111111111111111111
1111111111111111111110000000000000000000000000001100001110000011000000000000000011111111111111111111111
1111111111111111111110000000000000000000000000001100001110000111000000000000000011111111111111111111111
1111111111111111111110000000000000000000000000E01100001110011111000000000000000011111111111111111111111
1111111111111111111110000000000000000000000000C01100000000000000000000000000000011111111111111111111111
1111111111111111111110000000000000000000000000P01100000000000000000000000000000011111111111111111111111
1111111111111111111110000000000000000000000000000000000000000000000000000000000011111111111111111111111
1111111111111111111110000000000000000000000000000000000000000000000000000000000011111111111111111111111
1111111111111111111110000000000000000000000000000000000000000000000000000000000011111111111111111111111
1111111111111111111110000000000000000000000000000000000000000000000000000000000011111111111111111111111
1111111111111111111110000000000000000000000000000000000000000000000000000000000011111111111111111111111
1111111111111111111110000000000000000000000000000000000000000000000000000000000011111111111111111111111
1111111111111111111110000000000000000000000000000000000000000000000000000000000011111111111111111111111
1111111111111111111110000000000000000000000000000000000000000000000000000000000011111111111111111111111
1111111111111111111111111111111111111111111111111111111111111111111111111111111111111111111111111111111