1111111111111
1E10C010000E1
1010101011111
1010101010001
1010101010101
1010101000101
1010101111101
100000O000001
1011111011111
10000010000C1
1111101011111
10000010001C1
1011111010101
10000C1010101
1011111010101
1000001010101
1111101010101
1000001010101
1011111010101
1P000C10000P1
1111111111111
