1111111111111111111111111111111111111
1PPPPPPPPPPPPPPPPPPPPPPPPPPPPPPPPPPC1
1P1P1111111111111111111111111111111P1
1P1PPPPPPPPPPPPPPPPPPPPPPPPPPPPPPP1P1
1P1P11111111111111111111111111111P1P1
1P1P1E0000P00000000000000000000C1P1P1
1P1P1E0000P00000000000000000000C1P1P1
1P1P1E0000P00000000000000000000C1P1P1
1P1P1E0000P00000000000000000000C1P1P1
1P1P1E0000P00000000000000000000C1P1P1
1P1P1E0000P00000000100000000000C1P1P1
1P1P1E0000P00000001010000000000C1P1P1
1P1P1E0000P00000010PC1000000000C1P1P1
1P1P1E0000P00000001010000000000C1P1P1
1P1P1E0000P00000000E00000000000C1P1P1
1P1P1E0000P00000000000000000000C1P1P1
1P1P1E0000P00000000000000000000C1P1P1
1P1P1E0000P00000000000000000000C1P1P1
1P1P1E0000P00000000000000000000C1P1P1
1P1P11111111111111111111111111111P1P1
1P1PPPPPPPPPPPPPPPPPPPPPPPPPPPPPPP1P1
1P111111111111111111111111111111111P1
1EPPPPPPPPPPPPPPPPPPPPPPPPPPPPPPPPPP1
1111111111111111111111111111111111111