111111111111111111111
1PPPPPPPPPPPPPPPPPPC1
1P1P111111111111111P1
1P1PPPPPPPPPPPPPPP1P1
1P1P1111111111111P1P1
1P1P1E0000P0000C1P1P1
1P1P1111111111111P1P1
1P1PPPPPPPPPPPPPPP1P1
1P11111111111111111P1
1EPPPPPPPPPPPPPPPPPP1
111111111111111111111