11111111111111111111111111
1E0001000100C1C000010001E1
11110101010001000001010101
10000101010001000001010101
10000001000001000000010001
100000000P0001000P00000001
1CCCCCCCCCCCC1CCCCCCCCCCC1
1O0000000001111100000000O1
1CCCCCCCCCC1PCP1CCCCCCCCC1
111111111111PPP11111111111
1CCCCCCCCCC1PEP1CCCCCCCCC1
1000000000O11111O000000001
1CCCCCCCCCCCC1CCCCCCCCCCC1
100000000P0001000P00000001
10001000000001000010000001
10101010000001001010100001
10101010000001001010101111
1E1000100000C1C010001000E1
11111111111111111111111111