111111111111111111111
10000E0000100000E0001
100000O000100000000O1
1000010000100000O0001
1O0000000010001010001
100101010010O00000001
10000O000010010101001
10100100101000O000001
100000O00010C01010C01
10010C01001000O000001
10000O000010010C01001
10101C101010000O00001
100000000010101010101
1001010100100O0000001
100000000010010101001
100101010010000O00001
10000O000010101010101
10101010101000O000001
100000O00010010101001
1001010100100000O0001
100000P00010000P00001
111111111111111111111