111111111111111111111
10000E0000100000E0001
1000000000100000000O1
100000000010000000001
1O0000000010000000001
100000000010000000001
1000O0000010000000001
10000000001000O000001
1000O0O00010000000001
10000000001000O000001
10000O00001000000O001
100000000010000O00001
100000000C1C000000001
1000000000100O0000001
1000O0000010000000001
100000000010000O00001
10000O000010000000001
10000000001000O000001
100000O00010010101001
1001010100100000O0001
100000P00010000P00001
111111111111111111111