11111111111111111111111
10000E00000100000E00001
100000000001000000000O1
10000000000100000000001
1O000000000100000000001
10000000000100000000001
100000000001000000O0001
10000000000100000000001
1000O000000000000000001
10000000000100000000001
10000000000100000000001
1000000O000100000000001
1000000000C1C0000000001
10000000000100O00000001
10000000000100000000001
10000000000100000000001
10000000000100000000001
10000000000100000000001
10000000000100000000001
10000000000100000000001
100000P000010000P000001
11111111111111111111111