1111111111111
1PP10000000C1
1PP0011111001
1PP011E000001
1111111111111
