1111111111111
1P01000000OC1
1P00011111OO1
1P0011E000001
1111111111111