1111111111111
100P000000001
1000011111001
1P0011E000001
1111111111111