1111111111111
1E100010000E1
1010101011111
1010101000001
1010101001001
1010101001001
1010101111101
100000O000001
1011111011111
1000001000001
1111101011111
1000001000101
1011111010101
1000001010101
1000001010101
1111101010101
1000001010101
1C01111010101
1P000010000P1
1111111111111
