111111111111111111111
1P0010000000000000001
101011111111111111101
101010000000000000101
101010111111111110101
101010000000000C10101
101011111111111110101
101000000000000000101
101111111111111111101
1E00000000000000000P1
111111111111111111111