1111111111111111111111111111111111111
1000000000000000000000000000000000001
1000000000000000001111000011111011001
1000000000000000011100000011100011001
1000000000000001110000000011000011001
1000000000000011100000000000000011001
1000000000001110000000000000000011001
1000000000011100000000000000000011001
1000000001110000000000000000000011001
1000000111100000000000000000000111001
1000001110000000000000000000001111001
1000111000000000000000000000111100001
1001110000000000000000000011110000001
1001111111111111111100001110000000001
1001111111111111111100001110000000001
1000000000000000001100001110000011001
1000000000000000001100001110000111001
1000000000000000001100001110011111001
1000000000000000C01100000000000000001
1000000000000000P01100000000000000001
1000000000000000E01100000000000000001
1000000000000000000000000000000000001
1111111111111111111111111111111111111