1111111111111
1P010000000C1
10000111110P1
1P0011E000001
1111111111111