1111111111111
1001000000OC1
1000011111OO1
1P0011E000001
1111111111111